-14
17
-7
21
00000000000000000000000000000000
00000000000000000000000000000000
00000000000000000000000000000000
00000000000000000000000000000000
00000000000000000000000000000000
00000000000000000000000000000000
00000000000000000000000000000000
00000000000000000000000000000000
00000000000000000000000000000000
00000000000000000000000000000000
00000000000000000000000000000000
00000000000000000000000000000000
00000000000000000000000000000000
00000000000000000000000000000000
00000000000000000000000000000000
00000000000000000000000000000000
01001111111111111111110011100000
01000000000000111111100000100000
01000000000000111111100000100000
01000000000000111111111000100000
01000000000000111011100000100000
01000000000000000000000000100000
01000000000000000000000000100000
01000000000000000000010001100000
01000000000000000000010001100000
01000000000000000000010001100000
01000000000000000000011111100000
01111111111111111111111111100000
00000000000000000000000000000000
