-13
13
-6
6
000000000000000000000000000
100111111111111111111001110
100000000000011111110000010
100000000000011111110000010
100000000000011111111100010
100000000000011101110000010
100000000000000000000000010
100000000000000000000000010
100000000000000000001000110
100000000000000000001000110
100000000000000000001000110
100000000000000000001111110
111111111111111111111111110
